77777777777
66666666666
77777777777

77777777777
11111111111
77777777777