 833333338
 8       8
 8 88888 8
 8 8   8 8
 8 8 1 8 8
 8 8   8 8
 8 83338 8
 8       8
 888888888