77777777777
11111111111
66666666666
55555555555
22222222222
44444444444