00000000000
8         8
00000000000
67777777776
8         8
33333333333
57777777775
8         8
22222222222

22222222222
8         8