38555555583
36855555843
36685558443
36668384443
36666344443
36666344443
36666344443
76666344447
57666344475
55766344755
55576347555
55557 75555