44444444444

33388888888

11111111111

88888888333

22222222222

55588888888