 777777777
 7       7
 7 77777 7
 7 7   7 7
 7 7 7 7 7
 7 7   7 7
 7 77777 7
 7       7
 777777777