 8 8 8 8 8
 8 8 8 844
 8 8 8 8 8
 8 8 33333
 8 8 8 8 8
 8 8000000
 8 8 8 8 8
 822222222
 8 8 8 8 8
 666666666
 777777777